XXXXXXXXXXXXXXXXXXXXXXXXXXXXXXX
X   X               X     X   X
X X X XXXXXXX   XXX X X X X X X
X X X X     X   X X X X X X X X
X X X X XXX XXX X X X X X X X X
X X     X X   X X X       X X X
X X XXXXX X X XXX X XXX X X X X
X X X     X       X X X X   X X
X X X XXX XXX X X X X XXX XXX X
X X X X     X X X   X   X X X X
X XXX X XXX X X XXX X X X X X X
X     X X X X X X X X X X X X X
X XXX X X X X XXX X X XXX X X X
X X X     X X     X X     X X X
X X XXXXX X XXXXX XXX XXX X X X
X X X   X X     X     X X     X
X X X X X X XXX XXXXXXX XXXXX X
X X     X X X X X X         X X
X X XXX X XXX X X X XXX XXXXX X
X X X X X     X   X X X X   X X
X X X X XXX X XXXXX X X X X X X
X X X X   X X       X X X X X X
X X X XXX XXXXXXX X X X X X X X
X X X   X       X X   X X X X X
X X X X XXX XXX X X XXX X X X X
X X X X   X   X   X X   X   X X
X X X X X XXX XXX XXX XXX XXX X
X X X X     X   X     X   X X X
X X X XXXXX XXXXXXXXXXX XXX X X
X                           X X
XXXXXXXXXXXXXXXXXXXXXXXXXXXXXXX