XXXXXXXXXXXXXXXXXXXXXXXXXXXXXXX
X   X         X             X X
X X X XXX XXX X X XXX X XXXXX X
X X   X     X X X X X X X     X
X X XXX XXXXXXX XXX XXX X XXX X
X X X   X       X   X X X X X X
X X X XXX X XXXXX XXX XXX X X X
X X X X X X X             X X X
X X X X X X X XXXXXXX XXX X X X
X X     X X   X     X X X X X X
X XXXXXXX X XXX XXX X X X X X X
X X       X X   X X X X X X X X
X X X X X X X   X X X X X X X X
X X X X   X X   X   X   X X X X
X X X XXXXX X   X X XXX X X X X
X X X     X     X X   X     X X
X X X XXX XXXXXXX X X X XXX X X
X X X X X X     X X       X X X
X X X X X X XXX X XXXXXXXXX X X
X X X X     X X X         X X X
X X X X XXX X X X XXX X X X X X
X X X   X X   X X X X X X X X X
X X XXX X XXX X X X X X XXX X X
X X X X X   X X X X X X X X X X
X X X XXX X X X X X X XXX X X X
X X   X   X X X   X X     X X X
X X XXX X X X X XXX X XXXXX X X
X X X X X   X X X     X       X
X X X X XXX X XXX XXXXX X XXX X
X         X X               X X
XXXXXXXXXXXXXXXXXXXXXXXXXXXXXXX