XXXXXXXXXXXXXXXXXXXXXXXXXXXXXXX
X             X           X   X
X XXX XXX X XXX XXXXXXXXX X X X
X X X   X X X         X X   X X
X X XXX XXXXX XXXXXXXXX XXX X X
X X   X       X           X X X
X X X X X XXXXX XXX XXX X X X X
X X X X X X     X   X X X X X X
X X X X XXX X XXX X X X XXX X X
X X X X     X X X X         X X
X X X XXX XXXXX X X X XXX X X X
X X     X X     X X X X X X X X
X X XXX X X X X X XXX X X XXX X
X X X X X X X X X     X X     X
X X X X X X X X X XXX X X XXX X
X X X X X X X X X X X   X X X X
X X X XXX X X XXX X XXX X X X X
X X   X X X X     X   X X X X X
X X XXX X X XXX XXX XXX X X X X
X X X X X     X X X   X   X X X
X X X X XXX X X X X X X XXX X X
X X X X   X X X     X X     X X
X X X X X X X X XXXXX XXXXX X X
X X X X X X X X X       X X X X
X X X X X XXX X X XXXXX X X X X
X X X X X     X X       X   X X
X X X X X XXX XXX XXXXX X X X X
X X X X X   X     X     X X   X
X X X X XXX XXXXXXX XXXXX X X X
X         X                 X X
XXXXXXXXXXXXXXXXXXXXXXXXXXXXXXX