XXXXXXXXXXXXXXXXXXXXXXXXXXXXXXX
X                 X     X X   X
X XXX XXXXXXXXX X X XXXXX X X X
X X X X     X X X         X X X
X X X X XXX X X XXXXX XXX X X X
X X X   X X X X     X X X X X X
X X XXX X XXX XXXXX XXX X X X X
X X   X           X   X X X   X
X X X XXX XXXXXXXXX XXX X X X X
X X X   X X       X     X   X X
X X X X XXX XXXXX XXXXX XXXXX X
X X X X         X     X       X
X X X XXXXXXX X XXXXXXXXXXXXX X
X X X       X               X X
X X XXXXX X XXX XXXXXXX XXXXX X
X X   X X X   X X     X X X   X
X X X X XXXXX XXX XXXXXXX X X X
X X X X           X       X X X
X X X X XXX X XXXXX XXX X X X X
X X X   X X X X       X X X X X
X X XXXXX X XXX X   XXXXX X X X
X X X     X     X   X X X X X X
X X X X X XXXXX X XXX X X X X X
X X X X X     X X X X X X X X X
X X X X X XXX X X X X X XXX X X
X X X X   X X X   X X X       X
X X X X X X X X XXX X X   XXX X
X X X X X X X X X         X X X
X X X X X X X XXX XXXXXXXXX X X
X                             X
XXXXXXXXXXXXXXXXXXXXXXXXXXXXXXX