XXXXXXXXXXXXXXXXXXXXXXXXXXXXXXX
X X X                 X       X
X X X XXX X X XXX XXX X X XXX X
X X X X X X X X X   X   X X X X
X X X X X XXXXX XXXXXXXXXXX X X
X   X X X                   X X
X XXX X XXXXXXX X X X XXX X X X
X X   X         X X X X X X X X
X X XXX X XXXXX X X X X X XXX X
X X X   X   X X X X X X X     X
X X X X XXXXX X X X X X X X   X
X X X X       X X X X X X X   X
X X X X X X XXX X XXX X X XXX X
X X X X X X X X   X   X X X X X
X X X X X X X XXXXX XXX X X X X
X X X X X X X       X X X X   X
X X X X X XXX XXX XXX X X X X X
X X X X X         X   X X   X X
X X X X X X XXXXXXX XXX X XXX X
X X X X X X X           X X X X
X X X X X X X X XXXXXXX X X X X
X X X X X   X X X     X X X X X
X X X X X XXX X X XXX X X X X X
X X X X   X     X X X X X X X X
X X X XXX X X XXX X X XXX X X X
X X X   X X X X   X X     X X X
X X X X X X X X XXX XXX X X X X
X X X X X X X X X       X X X X
X X X XXXXX XXX X XXXXXXX X X X
X                             X
XXXXXXXXXXXXXXXXXXXXXXXXXXXXXXX