XXXXXXXXXXXXXXXXXXXXXXXXXXXXXXX
X                     X X     X
X X X XXX X XXXXXXXXX X X XXX X
X X X X X X X       X   X X X X
X X XXX X XXX X X   XXX X X X X
X X X   X X   X X       X X X X
X X X X XXX XXX XXX XXX X X X X
X X X X     X   X X X X X X   X
X X X XXX XXX XXX X X X X X X X
X X     X X X     X   X X X X X
X X XXX X X X XXX XXXXX X X X X
X X X X X X X X X     X X X X X
X XXX X XXX X X XXX XXX X X X X
X     X       X   X   X X X X X
X XXX X XXXXXXX X X X X X X X X
X X X X   X   X X   X X X X X X
X X X X XXX X X XXXXX X X X X X
X X X X X   X X X     X     X X
X X X XXX X X X X X XXX XXX X X
X X X     X   X X X   X X X X X
X X XXX X X XXX X XXX XXX X X X
X     X X X X   X   X     X X X
X XXX XXXXX X X X XXXXXXX X X X
X X X     X X X X X     X X X X
X X X XXX XXX XXX X X X X X X X
X X X   X         X X   X X X X
X X XXX X XXXXX XXX X X X X X X
X X   X X X   X X   X X X   X X
X X X XXXXX XXXXX X XXX X XXX X
X   X                         X
XXXXXXXXXXXXXXXXXXXXXXXXXXXXXXX