XXXXXXXXXXXXXXXXXXXXXXXXXXXXXXX
X                   X     X   X
X X XXX X XXXXX XXX X XXX X X X
X X X X X X X X X   X X X X X X
X X X XXXXX X X X XXX X X X X X
X X X       X X X X   X     X X
X X X XXX XXX X X X XXX X XXX X
X X   X X X   X   X X   X X X X
X X XXX XXX X XXX X X X XXX X X
X X X       X X X     X     X X
X X X X X X XXX X XXX XXXXX X X
X X X X X X X   X X X X   X   X
X X X X X X X X XXX XXX X X X X
X X X X X X X X         X X X X
X X X XXX XXX X XXX XXX X X X X
X X X X   X   X   X X X X X X X
X X X X X X X XXX XXX X X X X X
X X X X   X X   X     X X X X X
X X X X XXX XXX XXXXX X X X X X
X X X X X     X X   X X X X   X
X X X X X X X X X XXX X X XXX X
X X X X X X X X X X X   X   X X
X X X X X X X X X X XXX XXX X X
X X X X X X X X   X   X   X X X
X X X X X XXX XXX X X XXX X X X
X X     X       X X X X X   X X
X X XXX X XXXXX X X X X X XXX X
X X X X   X   X X X X X X X X X
X XXX XXX X XXX X X X X X X X X
X       X       X       X   X X
XXXXXXXXXXXXXXXXXXXXXXXXXXXXXXX