XXXXXXXXXXXXXXXXXXXXXXXXXXXXXXX
X                           X X
X XXX XXXXX XXXXX XXX X XXX X X
X X X     X X   X   X X X X   X
X X XXX X XXX X XXX X X X XXX X
X X   X       X   X   X X X X X
X X X XXXXXXX X X XXX XXX X X X
X X X       X X X       X X X X
X X XXXXX XXX X X X X XXX X X X
X X X   X X X X   X X X   X   X
X X X X X X X XXX X XXX XXX X X
X X X X X   X   X X X   X   X X
X X X X XXXXX XXX XXX XXX X X X
X X X X           X X X   X X X
X X X X X XXXXXXX X X X X X X X
X X     X X   X X X X X X X X X
X X XXXXXXX X X X X X X X X X X
X X X X     X   X X   X X X X X
X X X X X X XXX X X XXX X X X X
X X X X X X     X X X   X X X X
X X X X X X XXX XXX X X X XXX X
X X X X X X X X     X X X   X X
X X X X X XXX X X XXX X X X X X
X   X X X     X X X X X X X X X
X XXX X X XXX X X X X X X X X X
X X   X X X X X   X X X X   X X
X X XXX X X X X XXX X X XXX X X
X X X   X   X X X   X X   X X X
X X X X XXXXX XXX XXX XXX X X X
X                       X X   X
XXXXXXXXXXXXXXXXXXXXXXXXXXXXXXX