XXXXXXXXXXXXXXXXXXXXXXXXXXXXXXX
X                             X
X X XXX   XXX XXXXXXXXX XXX X X
X X X X   X X X     X X X   X X
X X X XXXXX X X XXXXX XXX X X X
X X X       X X X         X X X
X X X X XXX X X X X XXX X X X X
X X X X X X X   X X X X X X X X
X X X X X X XXX X X X X X XXX X
X X X X X X X X X X X X X   X X
X X X X X X X XXX X X XXX XXX X
X X X X   X X       X   X X   X
X X X XXX X X XXX X X X X X X X
X X X X X X   X X X X X   X X X
X X X X X X XXX XXXXX X X X X X
X X X X X X X         X X X X X
X X X X X X X XXXXXXX X XXX X X
X X X X X X X X       X       X
X X X X X XXX X XXXXX XXX XXX X
X X X X X       X X     X   X X
X X X X XXX XXX X X X X XXXXX X
X X X         X X X X X   X X X
X X X XXX XXX X X X X X XXX X X
X X   X X X X X X X   X X     X
X XXX X X X X X X X X XXX X X X
X   X X X X X X   X X X X X X X
X X XXX X X X XXXXX X X X X X X
X X     X X X       X X X X X X
X X XXX XXX X XXXXXXX X X X X X
X     X     X               X X
XXXXXXXXXXXXXXXXXXXXXXXXXXXXXXX