XXXXXXXXXXXXXXXXXXXXXXXXXXXXXXX
X                             X
X X X XXXXX XXXXX XXX XXX X X X
X X X X   X X   X   X X X X X X
X X X X X XXX XXXXX X X X XXX X
X X X X X           X X X   X X
X X XXX XXXXXXXXXXX XXX X X X X
X X   X   X       X     X X X X
X X XXX XXX X X XXXXXXX X X X X
X X X   X   X X X     X X X X X
X X X XXX XXX X X XXXXX XXX X X
X X X X X     X   X   X       X
X X X X X XXXXXXXXX X XXXXX X X
X X X X   X   X     X       X X
X X X X XXX X X XXX XXXXXXX X X
X X X X X   X   X X       X X X
X X X X X X XXXXX XXXXXXX X X X
X X X X X X     X   X X X X X X
X X X X X XXXXX X X X X X X X X
X X X X     X X X X   X X X X X
X XXX X XXXXX X X XXX X X X X X
X     X X     X     X X X X X X
X XXXXX X XXXXXXXXX XXX X XXX X
X X     X         X     X   X X
X X X XXX XXXXX   XXXXX XXXXX X
X X X X   X   X       X       X
X X XXX XXX X X XXX XXX XXX X X
X X     X   X X X X X X X X X X
X X XXXXX X X XXX XXX XXX XXX X
X           X                 X
XXXXXXXXXXXXXXXXXXXXXXXXXXXXXXX