XXXXXXXXXXXXXXXXXXXXXXXXXXXXXXX
X           X         X       X
X XXXXXXX XXX XXXXXXXXX X XXX X
X       X     X             X X
X XXXXX XXX X X X X XXX XXX X X
X X X X   X   X X X X X X   X X
X X X X X XXXXX X XXX XXX X X X
X X X X         X         X X X
X X X XXX XXXXX XXX XXXXX X X X
X     X X X   X   X X   X X X X
X XXX X XXX X XXX X X XXX X X X
X X X       X   X   X X X     X
X X XXX X XXX X XXXXX X XXXXX X
X X   X X   X X     X X   X X X
X X X X XXX XXX XXXXX X X X X X
X   X X X X X   X     X X   X X
X XXX X X XXX XXX XXX X X XXX X
X X   X X     X   X     X X   X
X X X X X XXXXX XXX XXXXX X X X
X X X X X X     X   X     X X X
X X X X X X X X X XXX XXXXX X X
X X X X X X X X X           X X
X X X X X X X X X XXXXXXX X X X
X X X X X X X X X X     X X X X
X X X XXX X XXX X X X X X X X X
X X X           X X X X X X X X
X X X XXXXXXXXXXX X X X X X X X
X X X   X         X X X X   X X
X X XXXXX XXXXXXXXX X X XXX X X
X                   X     X   X
XXXXXXXXXXXXXXXXXXXXXXXXXXXXXXX