XXXXXXXXXXXXXXXXXXXXXXXXXXXXXXX
X                       X     X
X X XXXXX XXXXXXXXX XXXXX XXX X
X X X X X         X X     X X X
X X X X X XXXXXXX XXX XXX X X X
X X   X X X     X     X X X   X
X X XXX X X X X XXX XXX X X X X
X X X X X X X X   X   X   X X X
X X X X X X X X XXXXXXX XXX X X
X X X X X X X         X X   X X
X X X X XXX XXXXXXXXX X X X X X
X X X               X X X X X X
X X X X X XXXXXXX XXX X X X X X
X X X X X     X X X   X X X X X
X X X X X XXX X X X X X X X X X
X X X X X X X X X X X X X X   X
X X X X X X X X X X X X X XXX X
X X X   X X X     X X   X   X X
X X X XXXXX XXXXXXX X XXX X X X
X X   X           X X X   X   X
X XXXXX XXXXX X XXX X X XXX X X
X   X       X       X X X X X X
X X X XXXXX XXX XXX X X X X X X
X X   X   X   X X X X X   X X X
X X XXX   XXX XXX X X X X X X X
X X X       X X X X   X X X X X
X XXX XXX X X X X XXX X X X X X
X     X X       X   X   X X X X
X XXXXX XXXXXXXXX X XXXXX X X X
X                 X         X X
XXXXXXXXXXXXXXXXXXXXXXXXXXXXXXX