XXXXXXXXXXXXXXXXXXXXXXXXXXXXXXX
X                             X
X X XXXXXXXXXXXXXXXXX XXX X X X
X X X             X X X     X X
X X X X X X XXX X X X X XXX X X
X X X X X X X X X   X     X X X
X X X X X X X X XXX XXX X X X X
X X X X X X X X   X   X X X X X
X X X X X XXX X XXX X X X X X X
X X X X X X       X X X X X X X
X X X X X X XXXXX X XXX X X X X
X X X X X   X   X X   X X X X X
X X X X XXXXX X X XXXXX X X X X
X X X X     X X X X X   X X X X
X X X XXX X X X X X X XXX X X X
X X     X     X X     X       X
X X XXX XXXXX X X XXXXX XXXXX X
X X X X     X     X     X   X X
X X X X XXX XXX X X XXX X X X X
X X X X X X   X X X X X X X X X
X X X X X XXX X XXX X X X X X X
X X X X X   X X     X X X   X X
X XXX X X X X XXXXX X XXX XXX X
X     X X X X     X X         X
X XXX XXX X XXX   X X X XXXXX X
X   X     X   X   X   X   X X X
X XXXXXXX XXX XXX XXX X XXX X X
X X     X   X   X   X X X   X X
X X XXXXXXX X X XXX X XXX X X X
X         X X X     X     X X X
XXXXXXXXXXXXXXXXXXXXXXXXXXXXXXX