XXXXXXXXXXXXXXXXXXXXXXXXXXXXXXX
X       X           X   X   X X
X X X X X XXX X XXX X X X X X X
X X X X   X X X X X X X X X X X
X X X XXX X X X X XXX XXX X X X
X X X   X   X   X       X X X X
X X X X XXX XXXXX XXXXX X X X X
X X X X   X       X   X X X X X
X X X XXX X X XXXXX   X X X X X
X X X X X X X X       X X X X X
X X X X X XXXXX XXXXX X X X X X
X X X X X           X   X X X X
X X X X XXX XXXXXXX X X X X X X
X X X X X X X   X X X   X X X X
X X X X X X X X X X X XXX X X X
X X X X X X   X X X X X   X X X
X X X X X XXX XXX X XXX X X X X
X X X X X X X X   X     X X X X
X X X X X X X X X XXXXX X X X X
X X X       X X     X X X X X X
X X XXXXXXX XXX XXX X XXX X X X
X X       X     X X     X   X X
X X X XXXXX XXXXX XXXXX XXX X X
X X X X   X           X     X X
X XXX X X X XXXXX XXX XXX X X X
X   X X X X X   X       X   X X
X X X X X XXX X XXXXXXX XXX X X
X X X   X             X X X X X
X X XXXXXXXXXXX XXXXXXXXX X X X
X                         X   X
XXXXXXXXXXXXXXXXXXXXXXXXXXXXXXX