XXXXXXXXXXXXXXXXXXXXXXXXXXXXXXX
X                         X   X
X X X XXX XXX XXXXXXX XXX X X X
X X X X X   X X       X X X X X
X X XXX XXX X X XXXXXXX X X X X
X X       X X   X     X X X   X
X XXX XXX X XXXXX XXXXX X X X X
X   X X X X       X     X X X X
X X X X X X XXX X X X XXXXX X X
X X X X     X X X   X X     X X
X X X X XXXXX X XXX XXX XXX X X
X X X             X       X X X
X X XXXXX XXXXXXX X XXXXX XXX X
X X     X       X X X   X   X X
X XXXXX XXXXXXX X X X X XXX X X
X     X   X   X   X X X   X X X
X X X XXXXX X XXX XXX X XXX X X
X X X       X   X     X X X X X
X X XXX X X XXX XXXXX X X X X X
X X     X X   X     X   X X X X
X X X X XXX X XXX X X XXX X X X
X X X X     X   X X X X   X X X
X XXX XXXXX XXX X X X X X X X X
X       X X   X X X   X X X X X
X XXXXX X XXXXX X XXXXX X X X X
X X X X X   X X X       X X X X
X X X X X X X X XXXXXXX X X X X
X X X X X X   X       X X X   X
X X X XXX XXX XXXXXXX XXX XXX X
X           X       X         X
XXXXXXXXXXXXXXXXXXXXXXXXXXXXXXX