XXXXXXXXXXXXXXXXXXXXXXXXXXXXXXX
X                     X   X X X
X XXXXX X XXX XXXXXXX X X X X X
X X   X   X     X   X X X X X X
X X X X X X XXX X XXX X X X X X
X X X X X X X X X   X X X X X X
X X X XXX X X X X XXX X X X X X
X X X       X X X X X X   X X X
X X X X XXXXX X X X X X XXX X X
X X X X X     X X X   X X   X X
X X X X X X XXX X X XXX X X X X
X X X X X X X     X X   X X X X
X X X X X X X XXXXX X   X XXX X
X X X X X X   X         X     X
X X X X X XXX X XXX XXXXX X X X
X X X X       X X X X   X X X X
X X X X XXXXXXX X XXX XXX X X X
X X X X X       X         X X X
X X X XXX X X XXX XXX XXX X X X
X X X     X X X X X X X X X X X
X X X X X X XXX X X X X X X X X
X X X X X X     X X X X X X X X
X X X XXX X XXXXX X X X X X X X
X X X   X   X X   X   X X X X X
X X X XXX X X X XXX XXX X X X X
X X X X X     X X     X X X X X
X X XXX X XXXXX X XXXXX X X X X
X X   X X X     X X     X X   X
X X XXX X X XXXXX X XXXXX XXX X
X                           X X
XXXXXXXXXXXXXXXXXXXXXXXXXXXXXXX