XXXXXXXXXXXXXXXXXXXXXXXXXXXXXXX
X                       X     X
X X X X X XXX XXXXX X XXX X X X
X X X X X X X X   X X     X X X
X X X XXX X X X X X XXXXX X X X
X X X     X X X X X     X X X X
X X X XXXXX XXX X XXX X X X X X
X X X     X           X X X X X
X X XXXXXXX XXXXXXXXX XXX X X X
X X X   X           X   X   X X
X X X X X XXXXX XXX X XXX X X X
X X X X X X X   X X X X X X X X
X X X X X X X X X X XXX X X X X
X X X X X X X X X X     X X X X
X X X X X X X XXX XXXXX X X X X
X X X X X X X         X   X   X
X X X X X X X X X XXX X X XXX X
X X   X X X X X X   X X X   X X
X X X X X X X X X X X X XXX X X
X X X X X X X X X X X X   X X X
X XXX XXX X X X X X X XXX X X X
X           X X         X X X X
X X XXXXXXXXX X X XXX XXX X X X
X X X     X   X X X X X X   X X
X XXX XXXXX XXXXX X X X XXX X X
X     X     X   X X X     X X X
X XXX X X XXX X X X XXX XXX X X
X X X X X X X X X X X X X X X X
X X XXX X X X XXX X X X X X X X
X               X         X   X
XXXXXXXXXXXXXXXXXXXXXXXXXXXXXXX