XXXXXXXXXXXXXXXXXXXXXXXXXXXXXXX
X     X     X         X     X X
X X X X XXX X X XXX XXX XXX X X
X X X X     X X X X X   X X X X
X X X X XXXXX XXX X X X X X X X
X X X   X         X X X X X X X
X X X X X X X X XXX X XXX X X X
X X X X X X X X X X X X   X X X
X X XXX X X X X X X X X X X X X
X X     X X X X       X X X X X
X X XXX X X X X XXXXX X X X X X
X X X   X   X X X X X X X X   X
X X X X X X X X X X X X X XXX X
X X X X X X     X           X X
X X X X X XXXXXXX XXXXXXXXX X X
X X X X X   X     X       X X X
X X X X X XXX XXXXX XXXXX XXX X
X X X X X X   X     X   X     X
X X X XXX X X X XXX X XXXXX X X
X X       X X X X X X     X X X
X XXX X   X X X X X X XXX X X X
X   X X   X X X X X X X X   X X
X X XXXXXXX X X X X X X X X X X
X X       X X X X X     X X   X
X X XXXXX X XXX X XXXXX X XXX X
X X X   X X X         X X   X X
X X X X XXX X X XXX X X XXX X X
X X X X     X X X X X X   X X X
X X X XXXXXXX XXX XXX XXX X X X
X                       X X X X
XXXXXXXXXXXXXXXXXXXXXXXXXXXXXXX