XXXXXXXXXXXXXXXXXXXXXXXXXXXXXXX
X   X           X   X       X X
X X X X XXXXXXX X X X XXX XXX X
X X X X X     X X X X X   X   X
X X X X X XXX X X X X X X X X X
X X X   X X X       X X X X X X
X X X XXX X X XXX   X X X X X X
X X X X   X X X X   X X X X X X
X X X X X X XXX XXX X X X X X X
X X   X X     X   X X   X X X X
X XXX X XXX XXX X XXX XXX X X X
X   X     X X X X     X   X X X
X X XXXXX X X X X XXX X XXX X X
X X     X X X   X X X X X X X X
X XXX X XXX X XXX X XXX X X X X
X   X X   X X X X     X X X X X
X X XXX X XXX X XXXXXXX X X X X
X X   X X     X             X X
X X XXX XXXXXXX X X XXXXXXX X X
X X   X     X   X X X     X X X
X XXX X XXXXX X XXX X X X X X X
X   X X X     X   X   X X X X X
X X X X X X XXXXX X XXXXX X X X
X X X X X X     X X X     X X X
X X X X X X XXX X XXX XXXXX X X
X X X X X X X   X         X X X
X X X X X XXX XXXXXXX XXX X X X
X X X X X X         X X X X   X
X X X XXX X XXXXXXX XXX X XXX X
X                           X X
XXXXXXXXXXXXXXXXXXXXXXXXXXXXXXX