XXXXXXXXXXXXXXXXXXXXXXXXXXXXXXX
X                             X
X X X XXX XXX XXX XXXXX XXX X X
X X X X X   X X X     X X X   X
X XXX X XXX XXX XXXXX XXX XXX X
X     X   X       X X   X   X X
X XXXXX X X XXXXX X X XXX XXX X
X X     X X     X X X       X X
X X X X X XXXXX X X X XXXXX X X
X X X X   X   X X     X   X   X
X X X X XXX X X XXX XXX X X X X
X X X X X   X X   X       X X X
X X X X X XXX XXX XXXXXXX X X X
X X X X X   X   X X   X X X   X
X X X X X XXX X XXX X X X XXX X
X X X   X X   X     X   X   X X
X X X X X X X X XXXXXXXXX X X X
X X X X X X X X X       X X X X
X X X X X X X X X XXXXX X X X X
X X X X X X X X   X   X X X X X
X X X X X X X X XXX XXX X X X X
X X X X X X X X X   X X X X   X
X X X X X X X X X XXX X XXX X X
X X X X   X X X X X       X X X
X X X XXXXX X X X X X XXXXX X X
X X X   X     X X   X X   X X X
X X X XXX XXXXX X XXX X X X X X
X X X X   X       X   X X X X X
X X XXX XXX XXXXXXX XXX XXX X X
X                             X
XXXXXXXXXXXXXXXXXXXXXXXXXXXXXXX