XXXXXXXXXXXXXXXXXXXXXXXXXXXXXXX
X               X             X
X X X X X XXX X X X X XXXXX X X
X X X X X X     X X X X     X X
X X X X X X XXXXX X XXX X X X X
X X X X X X X   X X X   X X X X
X X X X X X X   X XXX X X X X X
X X X X X X X   X X X X X X X X
X X X X X X X XXX X X X X XXX X
X X X X   X   X X X X X X   X X
X X X X XXX X X X X X X X XXX X
X X   X X   X X X X X X X   X X
X X XXX X XXX X X X X X X XXX X
X X X X X X     X X X X X X X X
X X X XXX X XXX X X X X XXX X X
X X X       X X X X X X       X
X X X X X XXX XXX X X XXXXXXX X
X X X X X X       X X     X X X
X X X X X X X XXX X X XXXXX X X
X X X X X X X X X           X X
X X X X XXX X X XXXXX XXXXX X X
X X X X   X X X     X X   X X X
X X X X X X X X XXX X X X X X X
X X X     X X   X X     X X X X
X X X XXX X X XXX XXX XXX X X X
X X X X X X X X     X X X X X X
X X X X XXX X X X X XXX X X X X
X X   X     X X X X X   X X X X
X XXXXX XXXXXXX XXXXX   X X X X
X                         X   X
XXXXXXXXXXXXXXXXXXXXXXXXXXXXXXX