XXXXXXXXXXXXXXXXXXXXXXXXXXXXXXX
X                           X X
X X X X XXX XXX X X X XXX X X X
X X X X X X   X X X X X X X X X
X X X X X XXX X X XXX X X X X X
X X X X X   X X X X X X   X X X
X X X X X X X XXX X X X X X X X
X X X X X X X       X X X X   X
X X X X X XXX X XXX X X XXX X X
X X X X X   X X X X   X     X X
X X X X X X X XXX X X X XXXXX X
X X X X X X X       X     X   X
X X X X X X X XXX X XXX XXX X X
X X X X     X X   X X X X X X X
X X X XXXXX X X XXXXX X X X X X
X X X     X X X X     X   X X X
X X X XXX X XXX X XXX XXXXX X X
X X X X X X     X X X       X X
X X X X X XXX X X X X XXX X X X
X X X X     X X X X   X X X X X
X X X X XXX X X X X XXX XXX X X
X X X   X X X X     X     X X X
X X XXXXX X X X XXXXX X X XXX X
X X       X X X X       X     X
X X XXXXX X X XXX XXXXXXX X X X
X X X X X X X   X X     X X   X
X X X X X X XXX X X X XXX X X X
X X X X X X   X   X X X X   X X
X XXX X X XXX XXXXX X X XXXXX X
X       X           X         X
XXXXXXXXXXXXXXXXXXXXXXXXXXXXXXX