XXXXXXXXXXXXXXXXXXXXXXXXXXXXXXX
X X                         X X
X X XXX XXXXXXX XXXXX XXX X X X
X   X X       X X   X   X X X X
X XXX X XXXXX X X X XXX X XXX X
X X     X X X X   X   X X X   X
X X X X X X X XXX XXXXX X X X X
X X X X X X X   X   X   X X X X
X X X X X X XXX XXX X XXX X X X
X X X X X     X   X X   X X X X
X X X X X XXX XXX XXX X X X X X
X X X X X X X   X     X X X X X
X X X XXX X XXX XXXXXXX XXX X X
X X X     X   X           X X X
X X X X X X X X XXXXXXX X X X X
X X X X     X X     X X X X X X
X X X XXXXXXX XXXXX X X X X X X
X X X     X       X   X X   X X
X X XXXXX X XXXXX XXX X XXX X X
X X     X   X   X   X X     X X
X X X X XXX X X XXX X XXXXXXX X
X X X X   X X X   X X   X X X X
X X X X X XXX X X X X X X X X X
X X X   X   X X X X X X X     X
X X XXX X X X X X XXX X X XXX X
X X   X X   X X     X X   X   X
X X X X XXXXX X XXX X X X X X X
X X X X   X X X X X   X X X X X
X X XXXXX X X XXX XXX XXX X X X
X       X           X       X X
XXXXXXXXXXXXXXXXXXXXXXXXXXXXXXX