XXXXXXXXXXXXXXXXXXXXXXXXXXXXXXX
X                             X
X X XXX XXXXXXX XXX XXXXX X X X
X X X X X   X X X X X   X X X X
X X X X X XXX X X XXX X X X X X
X X   X X     X     X X X X X X
X XXX XXX XXX XXXXX X X X X X X
X   X X   X X   X X X X X X X X
X X X X XXX X XXX XXX XXX X X X
X X X       X         X X X X X
X X XXXXXXX XXX XXXXX X X X X X
X X     X X X X X X X X     X X
X X X X X X X XXX X X X XXX X X
X X X X   X X   X     X X X X X
X X X XXX X X XXX X X X X XXX X
X X X     X   X   X X       X X
X X X XXX XXX X XXX XXXXXXX X X
X X X X X   X X X         X X X
X X X X X X X X X X XXX X X X X
X X   X   X X   X X X   X X X X
X X X X X X XXXXX X X X X X X X
X X X X X         X X X X X X X
X X X X X XXXXXXXXXXX X XXX X X
X X X X X X       X   X X   X X
X X XXX XXX XXX   X X X X XXX X
X X       X X X   X X X       X
X X XXX XXX X XXX X X X XXX X X
X X         X   X X X X X X X X
X XXXXXXXXXXX X XXX XXX X X X X
X             X             X X
XXXXXXXXXXXXXXXXXXXXXXXXXXXXXXX