XXXXXXXXXXXXXXXXXXXXXXXXXXXXXXX
X                             X
X X XXX XXXXXXXXX XXX X XXX X X
X X X X         X X   X   X X X
X X X XXX XXXXX XXX XXX XXXXX X
X X X     X   X   X X X X X   X
X X X XXX X XXXXXXX X XXX X X X
X X     X X               X X X
X XXXXX X X XXX XXXXXXXXXXX X X
X     X   X X X X           X X
X X XXXXX X X X X X XXXXXXX X X
X X   X X     X   X X     X X X
X XXX X XXXXX XXX XXX XXX X X X
X   X       X   X     X   X X X
X X XXXXX X XXX XXXXX X XXX X X
X X     X X   X     X X X X   X
X X X X X XXX XXXXX XXX X X X X
X X X X X         X         X X
X X X X XXXXXXX XXXXXXXXX X X X
X X X X       X X   X   X X X X
X X X XXXXX X X X X X X XXX X X
X X X   X X X X   X X X   X   X
X X X XXX XXX XXX X X XXX XXX X
X X X       X     X     X X X X
X X X XXXXXXX X X XXXXXXX X X X
X X X X X   X X X       X X X X
X X X X X X X X X   XXXXX X X X
X X X   X X X   X   X X X     X
X X XXXXX XXXXXXXXXXX X XXX X X
X                           X X
XXXXXXXXXXXXXXXXXXXXXXXXXXXXXXX