XXXXXXXXXXXXXXXXXXXXXXXXXXXXXXX
X         X           X X X X X
X X X XXXXX XXXXXXXXX X X X X X
X X X X X           X X X X X X
X XXX X X X X X X X X X X X X X
X     X X X X X X X X X X X X X
X XXXXX X X X X X X XXX X X X X
X X     X X     X   X   X     X
X X XXXXX X XXX X XXX XXX XXX X
X X X   X X X X X X   X X X   X
X X X X X X X XXX X XXX X X X X
X X   X   X X   X       X X X X
X X XXX XXX X XXX XXX X X X X X
X X X X X   X     X X X X X X X
X X X XXX X X XXX X XXX X X X X
X X X     X X X X X     X X X X
X X X XXX X X X XXX XXXXX X X X
X X X X X   X X     X     X X X
X X X X XXXXX X XXXXX XXX X X X
X X X   X     X X     X X X X X
X X X XXX X XXX X XXX X X X X X
X X X X   X X   X X X   X X X X
X X X X X X X X X X XXX X X X X
X X X X X X X X       X X X   X
X X X X XXXXX XXXXXXX X X X X X
X X X               X   X   X X
X X X XXX XXXXXXXXX XXX XXX X X
X X X X X X                 X X
X X X X XXX XXXXXXXXXXXXX XXX X
X                       X     X
XXXXXXXXXXXXXXXXXXXXXXXXXXXXXXX