XXXXXXXXXXXXXXXXXXXXXXXXXXXXXXX
X                             X
X X X X XXXXXXX XXXXXXX XXX X X
X X X X X   X X       X       X
X X XXXXX XXX X XXXXX XXX XXX X
X X X     X   X X   X   X X X X
X X X X X X X XXX X XXX X X X X
X X X X X X       X     X X X X
X X X X XXX XXX XXX XXXXX X X X
X X X X     X X X X X   X X   X
X X X X XXXXX X X XXX XXX X X X
X X X X X X X X         X X X X
X X X X X X X XXXXXXXXX X X X X
X X X X   X X       X   X X X X
X X X X XXX X X XXX X X X X X X
X X X X X   X X X X   X X X X X
X X X X X XXX X X X XXX X X X X
X X X X X     X X   X X   X X X
X X X X X XXX XXX X X XXXXX X X
X X X X X X     X X       X X X
X X X X X X XXX X XXXXXXXXX X X
X X   X X X X X X X     X   X X
X XXXXX X X X XXX X XXXXX XXX X
X     X X X         X     X X X
X XXX X X X XXX XXX X XXX X X X
X X   X X X X X X X X X X X X X
X X XXX X X X XXX X X X X X X X
X X X X   X X     X   X X X X X
X X X XXXXX X XXX XXXXX X X X X
X                             X
XXXXXXXXXXXXXXXXXXXXXXXXXXXXXXX