XXXXXXXXXXXXXXXXXXXXXXXXXXXXXXX
X                     X X   X X
X X X X XXXXX XXX X XXX X X X X
X X X X X X X X X X X X X X X X
X X X X X X XXX X X X X X X X X
X X X X X X   X X X     X X X X
X X X X X X XXX X XXXXX X X X X
X X X X X X X   X     X X     X
X X X X X X X X XXX X X X XXX X
X X X X X X X X   X X X   X   X
X X X X X X X X X X X XXXXX X X
X X X X X X X     X       X X X
X X X X X X X XXX XXXXXXXXX X X
X X X X     X X X           X X
X X XXXXX XXX X XXXXX XXXXXXX X
X X   X X X         X X       X
X X X X XXX XXXXXXXXX X X XXX X
X X X X     X       X X X X   X
X X X X XXXXX XXX XXX X X X X X
X X X X X     X X X X X   X X X
X X X X X XXXXX X X X X X X X X
X X X X X X       X X X X   X X
X X X X X X X X X X X X X XXX X
X X X X X X X X   X X X X X   X
X X X X X X X X X X X X X X X X
X X   X X X X   X X X     X X X
X XXXXX X X XXX X X X XXX X X X
X       X X   X X X X X X   X X
X XXXXXXX X X XXX X XXX XXX X X
X           X             X X X
XXXXXXXXXXXXXXXXXXXXXXXXXXXXXXX