XXXXXXXXXXXXXXXXXXXXXXXXXXXXXXX
X                         X   X
X X X X XXX XXXXX XXX X XXX X X
X X X X X X     X X   X     X X
X X X X X XXX X XXX XXX XXX X X
X X X X X   X X     X X X     X
X X X X X X X X XXX X X X XXX X
X X X X X X X X X X     X X X X
X X X X X X X XXX XXXXX X X X X
X X X X X X X   X     X X X   X
X X X X X X XXXXX XXX XXX X X X
X X X X X X       X X     X X X
X X X X X XXX XXXXX XXXXX X X X
X X X X   X X X         X     X
X X X XXXXX XXX X XXXXXXXXX X X
X X X         X X X       X X X
X X X XXX X X X XXX XXXXX X X X
X X X X X X X       X X   X X X
X X XXX X X XXXXXXX X X XXX X X
X X   X X X       X X X     X X
X X XXX X X XXXXX X X X XXX X X
X X     X X X     X   X X X X X
X X X X X X X X X XXXXX X X X X
X X X X X X X X         X X X X
X X X X X XXX X XXXXXXX X X X X
X X X X X     X X     X X X X X
X X X X X X X X X X X XXX X X X
X X     X X X X X X X       X X
X XXXXXXX X X XXX XXXXXXXXXXX X
X           X               X X
XXXXXXXXXXXXXXXXXXXXXXXXXXXXXXX