XXXXXXXXXXXXXXXXXXXXXXXXXXXXXXX
X   X           X             X
X X X XXX X XXX X X X   XXX X X
X X X X X X X X X X X   X X X X
X X X X X XXX XXX X XXX X X X X
X X   X X X X     X     X X X X
X X XXX XXX X X XXXXXXX X X X X
X X X         X X     X   X   X
X XXX XXX XXX XXX XXX XXX XXX X
X     X X X X     X X   X   X X
X XXX X XXX X XXXXX XXX XXX X X
X   X X       X       X   X X X
X XXX X X XXX X XXXXX X XXX X X
X X X X X X X X X   X X   X X X
X X X X XXX XXX X X X XXX X X X
X   X X         X X X X X X X X
X XXXXX XXX XXX X X XXX X X X X
X X     X X X X X X       X X X
X X X X X X X X X XXXXXXX X X X
X X X X X X X X X       X X X X
X X X XXX XXX X X XXXXX X X X X
X X X X           X   X X X X X
X X XXX X XXXXXXX X X X X X X X
X X     X X     X X X X X X X X
X X XXXXX X X X X X X X X X X X
X         X X X   X X X X X X X
X XXX XXX X XXX X X X X X X X X
X X X   X X X X   X X X X X   X
X X XXXXXXX X XXXXX XXX X X X X
X                       X   X X
XXXXXXXXXXXXXXXXXXXXXXXXXXXXXXX