XXXXXXXXXXXXXXXXXXXXXXXXXXXXXXX
X     X         X   X         X
X XXX X   XXX X X XXX XXXXX X X
X X X X   X X   X     X   X X X
X X X X XXX X XXX XXXXX X X X X
X X X X X     X   X     X X X X
X X X X X X XXX X X X X X X X X
X X X     X X   X X X X X X   X
X X XXXXX X X X X X X X X XXX X
X X     X   X X X X X X X   X X
X X XXX XXX X XXX X X X XXX X X
X     X   X     X X X X X X   X
X XXX XXXXXXX XXX X X X X X X X
X X X       X X   X X X   X X X
X X X XXX X XXX X X X X X X X X
X X X X X X     X X X   X X X X
X X X X X X XXX X X XXXXX X X X
X X X     X X X X X   X   X X X
X X XXXXX X X X X X XXX X X X X
X       X X X X X   X   X X X X
X XXXXX X XXX XXXXX X X X X X X
X X   X X           X X X X X X
X X X X XXXXXXX XXXXX X XXX X X
X X X X     X X X X X X       X
X X X X X XXX XXX X X X XXXXX X
X X X X X         X X X X   X X
X X X X XXX XXXXXXX X X X X X X
X X X X X X X       X X   X X X
X X XXXXX X X XXXXXXX XXXXX X X
X                           X X
XXXXXXXXXXXXXXXXXXXXXXXXXXXXXXX